000000000000000
100000011111110
110000011111110
111111111111110
111111111111110
111111111111110
111111111111110
111111100111110
111111111111110
111111111111110
111111111111110
111111111111110
111111111111110
111111111111110
111111111111111
